111111111111111111111
1E000001C01001000C001
100001000010C00100001
1000C0010000001001001
1000000C01000000000P1
111111111111111111111