

11111111111111111111
1E000001C01001000C01
100001000010C0010001
1000C001000000100101
1000000C0100000000P1
11111111111111111111


