


11111111111111111111
111C000000010001C001
1E110111110101111001
10000010010001000001
10001C10000101010101
10111111110101001011
1000C1P00001000000C1
11111111111111111111