1111111111111
10010010000E1
11010C1000C11
1000C00101001
1P00000000001
1111111111111